const map = [
  ["1", "-", "-", "-", "-", "-", "-", "-", "-", "-", "-", "-", "-", "-","-","-","-", "2"],
  ["|", " ", " ", "-", "-", "-", " ", " ", "2", "-", "-", " ", " ", " ", " ", " "," ", "|"],
  ["|", "4", "|", "4", " ", " ", " ", " ", "4", "-", " ", "|", " ", "-", " ", " "," ", "|"],
  ["|", "|", "3", "-", " ", " ", " ", " ", " ", " ", "-", "-", " ", "-", " ", " "," ", "|"],
  ["|", "|", " ", " ", " ", " ", " ", " ", " ", " ", " ", "|", " ", "-", " ", " "," ", "|"],
  ["|", "|", " ", " ", "-", " ", " ", " ", " ", " ", " ", " ", " ", " ", " ", " "," ", "|"],
  ["|", "4", " ", " ", " ", " ", " ", " ", "4", "4", " ", " ", " ", " ", " ", " "," ", "|"],
  ["|", " ", "2", "-", "-", "-", " ", " ", " ", " ", " ", " ", " ", " ", " ", " "," ", "|"],
  ["|", "|", "|", " ", " ", " ", " ", " ", " ", " ", " ", " ", " ", " ", " ", " "," ", "|"],
  ["|", "|", "4", "3", " ", " ", " ", " ", "1", " ", " ", " ", " ", " ", " ", " "," ", "|"],
  ["|", "4", " ", " ", "-", "-", "2", " ", " ", " ", "-", " ", "1", " "," ", "2"," ", "|"],
  ["|", "-", "-", "-", " ", "|", " ", " ", "-", "-", "-", " ", " ", " ", " ", " "," ", "|"],
  ["4", "-", "-", "-", "-", "-", "-", "-", "-", "-", "-", "-", "-", "-","-","-","-", "3"],
];